6x10
0010P0e0p0
10p01E1010
101010100K
X0P0pp0010
0110KC1010
000010p000
