10x8
0E000p00
00010000
K0100100
10X00011
e1101000
01K000C0
00p00010
00001010
P010000E
100K0100