9x11
00p00K0000K
0E000C000E0
00001110000
00P01E00e00
00E00X00000
00e00p10P00
00001110000
0p0P0C0e0p0
K00e0K00000
