11x9
X000p0000
111111110
00000E000
011111111
0000E0000
111111110
000e00000
011111111
000P00000
111111110
C0p000000
